XXXXXX
XEX XX
X    X
X X  X
X  XSX
XXXXXX