XXXXXXXXXSXXX
X   X   X X X
X X   X   X X
X XXXXXXXXX X
X X     X   X
X X XXX X X X
X X X X X X X
X   X   X X X
XXXXX  XX X X
X         X E
XXXXXXXXXXXXX  