XXXXXXXXXXXXXXSXXXX
XXX        X X  XXX
XXXX XXXXX   XX XXX
XXXX    XXXX XX XXX
XX   XX  XXX     XX
XXXXXXXX   XXXXX XX
X    XXX X X XXX XX
X XX X X  XX    XXX
X XXXX XX      XXXX
X    X XXXX  XXXXXX
X XXXX XXXX XXXXXXX
X XX     X   XXXXXX
X  XXXXXX XX   XXXX
XX XXXXX  XX XXXXXX
XX   XXXXXXX    XXX
XXXX XX  XXXXXX XXX
XXX   X XX      XXX
XXX X   XX XXXXXXXX
X  EXX        XXXXX
XXXXXXXXXXXXXXXXXXX